1111111111111111111111111
1000000000000000000000001
100C0000000111100000C0001
1000000000010C10000000001
1000000000010000000000001
1111110000010000000000001
10000000000111100000P0001
1000000000010C10000000001
1111111111111110000000001
1E0C00010000000000C000001
1000000100000000100000001
1000000000000000100000001
1111111111111111111111111
