1111111111111111111111
1P00000000000000010001
10000000000000000100C1
1111111000000000010001
1000000000000000110001
1C00000000000000000011
1100000000000000000111
1C00000011111100000001
10000000000E0000000001
1111111111111111111111
