1111111111111111111111111
1000000000000000000000001
1000000000000000000000001
1000000000011110000000001
1000000000010010000000001
1111110000010000000000001
1000010000011110000000001
1000010000000010000000001
1111111111111110000000001
1000000100000000000000001
1000000100000000100000001
1000000000000000100000001
1111111111111111111111111
