1111111111111111111111111111111111111111111111111111111111111111111111111
1000000000000000001110000000000000010000000000000000000000000100000000001
1000000000000000001110000000000000010000000000000000000000000110000000001
1000000000000000001110000000000000010000000000000000000000000100000000001
1000000000000000001110000000000000010000000000000000000000000100000000001
1000000000000000001110000000000000010000000000000000000000111100000000001
100000C000000000001110000000000000010000000000000000000000000000000000001
1000000000000000001110000000000000010000000000000000000000000000000000001
1000000000000000001110000000000000010000000000000000000000000000000000001
100000000000000000111000000000000E0100000000000000000P0000000000000000001
1000000000000000001110000000000000010000000000000000000000000000000000001
1000000000000000001110000000000000000000000000000000000000000000000000001
100000000000000000111000000000000001000000000000000000000000C000000000001
1000000000000000001110000000000000010000000000000000000000000000000000001
1000000000000000000000000000000000010000000000000000000000000000000000001
1000000000000000000000000000000000010000000000000000000000000000000000001
1000000000000000001110000000000000010000000000000000000000000000000000001
1000000000000000001110000000000000010000000000000000000000000000000000001
1000000000000000001110000000000000010000000000000000000000000000000000001
1000000000000000001110000000000000010000000000000000000000000000000000001
1000000000000000001110000000000000010000000000000000000000000000000000001
1000000000000000001111101001011011111110101000000000000000000000000000001
1000000000000000001110000000000000010000001000000000000000000000000000001
1000000000000000001110000000000000010000001000000000000000000000000000001
1000000000000000001110000000000000010000001000000000000000000000000000001
1000000000000000001110000000000000010000001111111000000000000000000000001
1000000000000000001110000000000000010000000000001000000000000000000000001
1000000000000C00001110000000000000010000000000001000000000000000000000001
1000000000000000001110000000000000010000000111111000000000000000000000001
10000000000000000011100000000000000100000001C0000000000000000000000000001
1000000000000000001110000000000000010000000000000000000000000000000000001
1000000000000000001110000000000000010000000000000000000000000000000000001
1111111111111111111111111111111111111111111111111111111111111111111111111
