111111111
111C00001
11E000P11
100000111
111111111
