111111111
 1C000P1
  10001
   1E1
   111
